R  55435435435400 300868454354354354354
NO          ./texture/colorstone.xpm
SO ./texture/greystone.xpm
EA ./texture/redbrick.xpm
S ./texture/barrel.xpm
F 255, 255, 25
       C 15, 15, 15
WE ./texture/wood.xpm

11111111111111111
10000000000000001
10000000200000001
10000000100000001
10000000100111001
100000001001 1001
10000000100111001
10000000000000001
10000000N00000001
10000000000000001
10000000000000001
10000000000000021
11111111111111111
